###############################
#..P1...........#..............#
#..............#..............#
#..............#..............#
#..........D1...#..............#
#..............#..............#
#########-############-########
#########-############-########
#########-############-########
#########-############-########
#########-############-########
#########-############-########
#########-############-########
#########..............########
#########..............########
#########..............########
###############################