##########
#........#
#P2.......#
#....D...#
#........#
##########
