##########
#........#
#P1.......#
#....D...#
#........#
##########
