###################################
#..............#.................##
#..............#.................##
#..............#....############-##
#..............#....############-##
#..............#....############-##
########....####################-##
#########-##########..............#
#########-##########..............#
#########-##########..............#
#########-##########..............#
########.......#####..............#
########.......#####..............#
########.......-----.......########
########.......#####.......########
####################.......########
########.......#####.......########
########.......#####.......########
########.......-----.......########
###################################