##########
#........#
#...D....#
#........#
#...P1....#
##########
