##########
#..D.....#
#......P1.#
#........#
#........#
##########
