##########
#........#
#........#
#...P1....#
#......D.#
##########
