##########
#........#
#........#
#........#
#....P1..D#
##########
