##########
#........#
#........#
#...P1..D.#
#........#
##########
