##########
#........#
#......D.#
#........#
#......P1.#
##########
