##########
#........#
#.....P1..#
#.D......#
#........#
##########
