##########
#.....D..#
#.......P1#
#........#
#........#
##########
