##########
#P1.......#
#........#
#D.......#
#........#
##########
