##########
#......D.#
#........#
#........#
#....P1...#
##########
