##########
#...P1....#
#........#
#........#
#.......D#
##########
