##########
#........#
#...D....#
#.P1......#
#........#
##########
