##########
#.....D..#
#.....P1..#
#........#
#........#
##########
