##########
#........#
#........#
#........#
#......DP1#
##########
