##########
#........#
#........#
#....P1D..#
#........#
##########
