##########
#........#
#.D......#
#........#
#....P1...#
##########
