##########
#..D.P1...#
#........#
#........#
#........#
##########
