##########
#........#
#......P1.#
#......D.#
#........#
##########
