##########
#..P1.....#
#........#
#...D....#
#........#
##########
