##########
#........#
#P1.....D.#
#........#
#........#
##########
