##########
#........#
#...D....#
#....P1...#
#........#
##########
