##########
#........#
#........#
#D.......#
#.....P1..#
##########
