##########
#.......P1#
#........#
#........#
#D.......#
##########
