##########
#....DP1..#
#........#
#........#
#........#
##########
