##########
#........#
#........#
#....D...#
#.P1......#
##########
