##########
#........#
#........#
#....P1...#
#.D......#
##########
