##########
#.......D#
#....P1...#
#........#
#........#
##########
