##########
#........#
#........#
#.D......#
#.....P1..#
##########
