##########
#........#
#....P1..D#
#........#
#........#
##########
