##########
#........#
#........#
#.....D..#
#.....P1..#
##########
