##########
#...D....#
#........#
#........#
#...P1....#
##########
