##########
#........#
#........#
#........#
#...D..P1.#
##########
