##########
#........#
#........#
#...D..P1.#
#........#
##########
