##########
#........#
#........#
#.....D..#
#.P1......#
##########
