##########
#.D......#
#........#
#........#
#..P1.....#
##########
