##########
#........#
#........#
#.....P1..#
#D.......#
##########
