##########
#........#
#........#
#.......D#
#...P1....#
##########
