##########
#....D...#
#........#
#P1.......#
#........#
##########
