##########
#.....D..#
#P1.......#
#........#
#........#
##########
