##########
#........#
#...P1....#
#...D....#
#........#
##########
