##########
#........#
#........#
#...P1.D..#
#........#
##########
