##########
#........#
#....P1...#
#.......D#
#........#
##########
