##########
#......D.#
#P1.......#
#........#
#........#
##########
