##########
#........#
#.......D#
#......P1.#
#........#
##########
