##########
#........#
#.....D..#
#....P1...#
#........#
##########
