##########
#.D......#
#........#
#.....P1..#
#........#
##########
