#############
#...#..P#...#
#...#...#...#
#...........#
#..........D#
#...#...#...#
#...#...#...#
#############