#############
#.D.#...#...#
#...#...#...#
#...........#
#....P1......#
#...#...#...#
#...#...#...#
#############
