#############
#...#...#...#
#...#...#...#
#...........#
#...........#
#...#...#...#
#...#D..#.P1.#
#############
