#############
#...#...#...#
#...#...#...#
#...........#
#.........P1D#
#...#...#...#
#...#...#...#
#############
