#############
#...#...#...#
#...#...#...#
#..........P1#
#.......D...#
#...#...#...#
#...#...#...#
#############
