#############
#...#...#...#
#...#...#...#
#...........#
#......P1....#
#.D.#...#...#
#...#...#...#
#############
