#############
#...#...#...#
#.D.#...#...#
#...........#
#..........P1#
#...#...#...#
#...#...#...#
#############
