#############
#...#...#...#
#...#...#...#
#...........#
#.......P1...#
#...#...#.D.#
#...#...#...#
#############
