#############
#...#...#...#
#...#...#...#
#...........#
#........P1..#
#...#D..#...#
#...#...#...#
#############
