#############
#...#...#...#
#...#...#...#
#........P1..#
#...........#
#...#...#...#
#...#...#.D.#
#############
