#############
#...#...#..D#
#...#...#...#
#...........#
#...........#
#...#...#...#
#...#..P1#...#
#############
