#############
#...#...#...#
#...#...#...#
#..........P1#
#...........#
#...#D..#...#
#...#...#...#
#############
