#############
#...#...#...#
#...#.DP1#...#
#...........#
#...........#
#...#...#...#
#...#...#...#
#############
