#############
#...#...#...#
#...#...#...#
#...........#
#.......P1D..#
#...#...#...#
#...#...#...#
#############
