#############
#...#.D.#...#
#...#...#...#
#...P1.......#
#...........#
#...#...#...#
#...#...#...#
#############
