#############
#...#...#...#
#...#...#...#
#.........P1.#
#...........#
#...#D..#...#
#...#...#...#
#############
