#############
#...#...#...#
#...#...#...#
#...........#
#.........D.#
#...#.P1.#...#
#...#...#...#
#############
