#############
#...#...#...#
#...#...#...#
#D..........#
#P1..........#
#...#...#...#
#...#...#...#
#############
