#############
#...#...#...#
#..P1#...#...#
#D..........#
#...........#
#...#...#...#
#...#...#...#
#############
