#############
#...#...#...#
#P1..#...#.D.#
#...........#
#...........#
#...#...#...#
#...#...#...#
#############
