#############
#...#...#...#
#...#...#...#
#...........#
#...........#
#...#...#.D.#
#...#P1..#...#
#############
