#############
#...#...#...#
#...#...#...#
#...........#
#...........#
#...#..P1#...#
#D..#...#...#
#############
