#############
#...#...#...#
#D..#...#...#
#...........#
#...........#
#...#...#...#
#..P1#...#...#
#############
