#############
#...#...#...#
#...#...#...#
#...........#
#...........#
#...#...#D..#
#...#...#..P1#
#############
