#############
#...#...#...#
#...#P1..#...#
#....D......#
#...........#
#...#...#...#
#...#...#...#
#############
