#############
#...#..P1#...#
#...#...#...#
#...........#
#...D.......#
#...#...#...#
#...#...#...#
#############
