#############
#...#...#...#
#...#...#...#
#..P1........#
#...........#
#...#...#...#
#...#...#..D#
#############
