#############
#D..#...#...#
#...#...#...#
#...........#
#.......P1...#
#...#...#...#
#...#...#...#
#############
