#############
#...#...#...#
#...#...#...#
#...D....P1..#
#...........#
#...#...#...#
#...#...#...#
#############
