#############
#...#D..#...#
#...#...#...#
#...........#
#...........#
#.P1.#...#...#
#...#...#...#
#############
