#############
#...#...#...#
#...#...#...#
#...........#
#...........#
#..D#...#...#
#...#P1..#...#
#############
