#############
#...#...#...#
#...#...#..P1#
#...........#
#...........#
#...#.D.#...#
#...#...#...#
#############
