#############
#...#...#...#
#...#...#...#
#D.P1........#
#...........#
#...#...#...#
#...#...#...#
#############
