#############
#...#...#...#
#...#...#...#
#......D....#
#...........#
#...#...#...#
#...#...#..P1#
#############
