#############
#...#...#..D#
#...#...#...#
#..........P1#
#...........#
#...#...#...#
#...#...#...#
#############
