#############
#...#...#...#
#...#...#...#
#...D.......#
#....P1......#
#...#...#...#
#...#...#...#
#############
