#############
#..D#...#...#
#...#...#...#
#...........#
#.P1.........#
#...#...#...#
#...#...#...#
#############
