#############
#...#...#...#
#...#...#...#
#...........#
#..........D#
#...#.P1.#...#
#...#...#...#
#############
