#############
#...#...#...#
#...#...#...#
#...........#
#..........D#
#...#...#...#
#..P1#...#...#
#############
