#############
#...#...#...#
#...#.P1.#...#
#...........#
#.D.........#
#...#...#...#
#...#...#...#
#############
