#############
#...#...#...#
#...#...#...#
#...........#
#....D......#
#...#..P1#...#
#...#...#...#
#############
