#############
#..D#...#...#
#...#...#...#
#......P1....#
#...........#
#...#...#...#
#...#...#...#
#############
