#############
#...#...#...#
#...#...#...#
#...........#
#..........P1#
#D..#...#...#
#...#...#...#
#############
