#############
#...#...#.P1.#
#...#...#...#
#...........#
#...........#
#..D#...#...#
#...#...#...#
#############
