#############
#...#...#...#
#...#...#D..#
#...........#
#.....P1.....#
#...#...#...#
#...#...#...#
#############
