#############
#...#...#...#
#...#..P1#...#
#...........#
#...........#
#...#...#...#
#...#...#.D.#
#############
