#############
#...#...#...#
#...#...#..P1#
#...........#
#...........#
#...#...#...#
#D..#...#...#
#############
