#############
#...#..P1#...#
#...#...#...#
#...........#
#...........#
#...#...#.D.#
#...#...#...#
#############
