#############
#...#D..#...#
#...#...#...#
#...........#
#P1..........#
#...#...#...#
#...#...#...#
#############
