#############
#...#...#...#
#...#...#...#
#..P1........#
#...........#
#...#...#..D#
#...#...#...#
#############
