#############
#...#...#...#
#...#...#...#
#...........#
#.......P1...#
#...#...#D..#
#...#...#...#
#############
