#############
#...#...#...#
#...#P1..#...#
#...........#
#...........#
#...#...#...#
#...#...#D..#
#############
