#############
#...#.D.#...#
#...#...#...#
#...........#
#...........#
#...#...#...#
#...#...#.P1.#
#############
