#############
#...#...#...#
#...#..P1#...#
#...........#
#...........#
#...#..D#...#
#...#...#...#
#############
