#############
#...#..D#...#
#...#P1..#...#
#...........#
#...........#
#...#...#...#
#...#...#...#
#############
