#############
#...#...#...#
#...#...#...#
#...........#
#.....P1...D.#
#...#...#...#
#...#...#...#
#############
