#############
#D..#...#...#
#...#...#...#
#...........#
#...........#
#...#.P1.#...#
#...#...#...#
#############
