#############
#...#...#...#
#...#...#...#
#...........#
#......D....#
#.P1.#...#...#
#...#...#...#
#############
