#############
#.D.#...#...#
#...#...#...#
#...........#
#...........#
#.P1.#...#...#
#...#...#...#
#############
