#############
#...#P1..#...#
#.D.#...#...#
#...........#
#...........#
#...#...#...#
#...#...#...#
#############
