#############
#..D#...#...#
#...#...#P1..#
#...........#
#...........#
#...#...#...#
#...#...#...#
#############
