#############
#...#...#D..#
#...#...#..P1#
#...........#
#...........#
#...#...#...#
#...#...#...#
#############
