#############
#...#...#...#
#...#...#...#
#........P1..#
#...........#
#..D#...#...#
#...#...#...#
#############
