#############
#...#...#...#
#...#...#D..#
#...........#
#....P1......#
#...#...#...#
#...#...#...#
#############
