#############
#...#...#.D.#
#...#...#...#
#...........#
#...........#
#...#...#...#
#...#...#P1..#
#############
