#############
#...#...#...#
#...#...#...#
#D......P1...#
#...........#
#...#...#...#
#...#...#...#
#############
