#############
#...#...#P1..#
#...#...#...#
#..D........#
#...........#
#...#...#...#
#...#...#...#
#############
