#############
#...#...#...#
#...#...#...#
#...........#
#...P1.......#
#...#...#...#
#...#...#..D#
#############
