#############
#...#...#...#
#.D.#...#...#
#..........P1#
#...........#
#...#...#...#
#...#...#...#
#############
