#############
#...#...#...#
#...#...#...#
#.P1.........#
#...........#
#..D#...#...#
#...#...#...#
#############
