#############
#...#...#...#
#...#...#.P1.#
#.......D...#
#...........#
#...#...#...#
#...#...#...#
#############
