#############
#...#..P1#...#
#...#D..#...#
#...........#
#...........#
#...#...#...#
#...#...#...#
#############
