#############
#...#...#..D#
#...#...#...#
#...........#
#...P1.......#
#...#...#...#
#...#...#...#
#############
