#############
#...#...#...#
#...#...#...#
#...........#
#.........P1.#
#...#...#D..#
#...#...#...#
#############
