#############
#...#...#...#
#...#...#...#
#...........#
#...........#
#...#...#.P1.#
#...#.D.#...#
#############
