#############
#...#...#...#
#...#...#...#
#...........#
#P1.....D....#
#...#...#...#
#...#...#...#
#############
