#############
#...#.P1.#...#
#...#...#...#
#...........#
#...........#
#.D.#...#...#
#...#...#...#
#############
