#############
#...#...#...#
#...#...#...#
#........P1..#
#...........#
#...#...#..D#
#...#...#...#
#############
