#############
#...#...#...#
#...#...#...#
#.P1....D....#
#...........#
#...#...#...#
#...#...#...#
#############
