#############
#...#...#...#
#...#..D#...#
#...........#
#...P1.......#
#...#...#...#
#...#...#...#
#############
