#############
#...#...#...#
#...#...#...#
#P1..........#
#....D......#
#...#...#...#
#...#...#...#
#############
