#############
#...#..D#...#
#...#.P1.#...#
#...........#
#...........#
#...#...#...#
#...#...#...#
#############
