#############
#...#...#.P1.#
#...#...#..D#
#...........#
#...........#
#...#...#...#
#...#...#...#
#############
