#############
#...#...#...#
#...#..D#...#
#...........#
#...........#
#...#P1..#...#
#...#...#...#
#############
