#############
#...#...#...#
#...#.P1.#.D.#
#...........#
#...........#
#...#...#...#
#...#...#...#
#############
