#############
#...#...#...#
#...#...#...#
#...D.P1.....#
#...........#
#...#...#...#
#...#...#...#
#############
