#############
#...#...#...#
#.P1.#...#...#
#...........#
#...........#
#...#D..#...#
#...#...#...#
#############
