#############
#...#...#...#
#...#...#...#
#...........#
#...........#
#D..#...#...#
#..P1#...#...#
#############
