#############
#...#...#...#
#...#...#...#
#.P1.........#
#..........D#
#...#...#...#
#...#...#...#
#############
