#############
#...#...#...#
#...#...#...#
#..D........#
#...........#
#...#...#...#
#...#P1..#...#
#############
