#############
#...#...#...#
#P1..#...#...#
#...........#
#...........#
#.D.#...#...#
#...#...#...#
#############
