#############
#...#.D.#...#
#.P1.#...#...#
#...........#
#...........#
#...#...#...#
#...#...#...#
#############
