#############
#...#...#...#
#...#...#...#
#...........#
#..P1........#
#...#...#...#
#...#.D.#...#
#############
