#############
#..P1#...#...#
#...#...#...#
#...........#
#...........#
#..D#...#...#
#...#...#...#
#############
