#############
#...#...#...#
#...#...#...#
#.P1.........#
#...D.......#
#...#...#...#
#...#...#...#
#############
