#############
#...#...#...#
#...#...#...#
#...........#
#D..........#
#...#...#P1..#
#...#...#...#
#############
