#############
#...#.D.#...#
#...#...#...#
#...........#
#......P1....#
#...#...#...#
#...#...#...#
#############
