#############
#...#...#...#
#...#...#...#
#......D....#
#......P1....#
#...#...#...#
#...#...#...#
#############
