#############
#...#...#...#
#.D.#...#...#
#...........#
#...........#
#...#...#...#
#...#...#.P1.#
#############
