#############
#D..#...#...#
#...#...#...#
#...........#
#...........#
#...#...#...#
#..P1#...#...#
#############
