#############
#...#..D#...#
#...#...#...#
#...........#
#.........P1.#
#...#...#...#
#...#...#...#
#############
