#############
#DP1.#...#...#
#...#...#...#
#...........#
#...........#
#...#...#...#
#...#...#...#
#############
