#############
#...#...#...#
#...#...#...#
#........D..#
#...P1.......#
#...#...#...#
#...#...#...#
#############
