#############
#...#...#...#
#...#...#...#
#...........#
#...........#
#...#...#P1..#
#...#..D#...#
#############
