#############
#...#...#..P1#
#...#...#...#
#..........D#
#...........#
#...#...#...#
#...#...#...#
#############
