#############
#...#...#...#
#...#...#...#
#...........#
#......P1....#
#...#...#...#
#...#D..#...#
#############
