#############
#...#...#.D.#
#...#...#...#
#...........#
#...........#
#...#P1..#...#
#...#...#...#
#############
