#############
#...#..D#...#
#...#...#...#
#...........#
#...........#
#...#...#P1..#
#...#...#...#
#############
