#############
#.P1.#...#...#
#...#...#...#
#...........#
#...........#
#D..#...#...#
#...#...#...#
#############
