#############
#..P1#...#...#
#...#...#...#
#...........#
#...........#
#...#...#...#
#...#..D#...#
#############
