#############
#..D#...#...#
#...#...#...#
#...........#
#...........#
#...#...#..P1#
#...#...#...#
#############
