#############
#...#...#...#
#...#...#...#
#..........D#
#...........#
#P1..#...#...#
#...#...#...#
#############
