#############
#...#...#...#
#...#...#...#
#.....D.....#
#......P1....#
#...#...#...#
#...#...#...#
#############
