#############
#.P1.#...#...#
#...#...#...#
#.D.........#
#...........#
#...#...#...#
#...#...#...#
#############
