#############
#...#...#...#
#...#...#...#
#......D....#
#...........#
#...#.P1.#...#
#...#...#...#
#############
