#############
#...#...#...#
#...#...#...#
#...........#
#...........#
#...#.D.#...#
#P1..#...#...#
#############
