#############
#...#...#...#
#...#...#...#
#...........#
#....D......#
#...#...#...#
#...#...#P1..#
#############
