#############
#...#...#...#
#...#...#...#
#...........#
#...........#
#...#D..#...#
#P1..#...#...#
#############
