#############
#...#...#...#
#...#...#...#
#...........#
#...........#
#...#D..#...#
#...#.P1.#...#
#############
