#############
#...#...#...#
#...#...#..P1#
#..........D#
#...........#
#...#...#...#
#...#...#...#
#############
