#############
#...#...#...#
#D..#...#...#
#...........#
#...........#
#...#...#..P1#
#...#...#...#
#############
