#############
#...#P1..#...#
#...#...#...#
#.......D...#
#...........#
#...#...#...#
#...#...#...#
#############
