#############
#.........P1.#
#...........#
#......D....#
#...........#
#...........#
#...........#
#############
