#############
#...........#
#....P1......#
#...........#
#D..........#
#...........#
#...........#
#############
