#############
#.......P1...#
#...........#
#...........#
#...........#
#.......D...#
#...........#
#############
