#############
#...........#
#........D..#
#...........#
#P1..........#
#...........#
#...........#
#############
