#############
#...........#
#...........#
#..P1........#
#...........#
#...........#
#..D........#
#############
