#############
#...........#
#...........#
#...........#
#.P1.........#
#........D..#
#...........#
#############
