#############
#D.....P1....#
#...........#
#...........#
#...........#
#...........#
#...........#
#############
