#############
#...........#
#...........#
#........P1..#
#...........#
#...........#
#....D......#
#############
