#############
#...........#
#...........#
#...........#
#...P1.......#
#...........#
#.........D.#
#############
