#############
#...........#
#...........#
#.........D.#
#......P1....#
#...........#
#...........#
#############
