#############
#...........#
#...........#
#...........#
#......P1....#
#...........#
#.....D.....#
#############
