#############
#...........#
#...........#
#...........#
#.D.........#
#...........#
#..P1........#
#############
