#############
#...........#
#....D......#
#.P1.........#
#...........#
#...........#
#...........#
#############
