#############
#...........#
#...........#
#...........#
#...........#
#...P1...D...#
#...........#
#############
