#############
#...........#
#D.......P1..#
#...........#
#...........#
#...........#
#...........#
#############
