#############
#...........#
#...........#
#...........#
#........D..#
#.........P1.#
#...........#
#############
