#############
#......D....#
#...........#
#...........#
#...........#
#...........#
#..........P1#
#############
