#############
#...........#
#....D......#
#...........#
#...........#
#..P1........#
#...........#
#############
