#############
#...........#
#...........#
#......P1....#
#.........D.#
#...........#
#...........#
#############
