#############
#...........#
#..D........#
#.....P1.....#
#...........#
#...........#
#...........#
#############
