#############
#....P1D.....#
#...........#
#...........#
#...........#
#...........#
#...........#
#############
