#############
#...........#
#...........#
#...........#
#...D.......#
#.P1.........#
#...........#
#############
