#############
#...........#
#...........#
#........D..#
#...........#
#...........#
#....P1......#
#############
