#############
#........D..#
#...........#
#...........#
#...........#
#...........#
#......P1....#
#############
