#############
#...P1.......#
#..........D#
#...........#
#...........#
#...........#
#...........#
#############
