#############
#...........#
#...........#
#...........#
#D.....P1....#
#...........#
#...........#
#############
