#############
#.D.........#
#...........#
#...........#
#...........#
#...........#
#......P1....#
#############
