#############
#...........#
#......D....#
#...........#
#....P1......#
#...........#
#...........#
#############
