#############
#...........#
#...........#
#...........#
#...........#
#...P1.......#
#......D....#
#############
