#############
#...........#
#.....P1.....#
#...........#
#...........#
#.D.........#
#...........#
#############
