#############
#...........#
#...........#
#...........#
#...........#
#...........#
#.......D..P1#
#############
