#############
#..P1........#
#...........#
#...........#
#...........#
#..D........#
#...........#
#############
