#############
#...........#
#...........#
#...........#
#...........#
#...P1.......#
#.......D...#
#############
