#############
#...........#
#...........#
#...........#
#D..........#
#...........#
#....P1......#
#############
