#############
#...........#
#......P1....#
#...........#
#...........#
#.......D...#
#...........#
#############
