#############
#...........#
#.......D...#
#...........#
#...........#
#...P1.......#
#...........#
#############
