#############
#...........#
#...........#
#.........P1.#
#D..........#
#...........#
#...........#
#############
