#############
#...........#
#...........#
#...........#
#...........#
#...........#
#.P1.D.......#
#############
