#############
#...........#
#...........#
#...........#
#..D........#
#..P1........#
#...........#
#############
