#############
#...........#
#...........#
#...........#
#..D.....P1..#
#...........#
#...........#
#############
