#############
#...........#
#..........P1#
#...........#
#...........#
#...........#
#........D..#
#############
