#############
#.....D.....#
#.....P1.....#
#...........#
#...........#
#...........#
#...........#
#############
