#############
#...........#
#...........#
#...........#
#...P1.D.....#
#...........#
#...........#
#############
