#############
#P1..........#
#...........#
#...........#
#...........#
#...........#
#......D....#
#############
