#############
#...........#
#...........#
#...........#
#...........#
#.......P1...#
#.....D.....#
#############
