#############
#...P1.......#
#...........#
#...........#
#...........#
#..D........#
#...........#
#############
