#############
#.....P1.....#
#...........#
#...........#
#...D.......#
#...........#
#...........#
#############
