#############
#...........#
#...........#
#...........#
#...........#
#.........P1.#
#...D.......#
#############
