#############
#...........#
#..........P1#
#...........#
#....D......#
#...........#
#...........#
#############
