#############
#...........#
#...........#
#...........#
#...........#
#.........D.#
#...P1.......#
#############
