#############
#...........#
#.....P1.....#
#..........D#
#...........#
#...........#
#...........#
#############
