#############
#...........#
#D...P1......#
#...........#
#...........#
#...........#
#...........#
#############
