#############
#...........#
#...........#
#..D........#
#...........#
#..........P1#
#...........#
#############
