#############
#...........#
#....P1....D.#
#...........#
#...........#
#...........#
#...........#
#############
