#############
#...........#
#....P1......#
#..........D#
#...........#
#...........#
#...........#
#############
