#############
#...P1.......#
#...........#
#D..........#
#...........#
#...........#
#...........#
#############
