#############
#...........#
#...........#
#...........#
#...........#
#.....D.....#
#..P1........#
#############
