#############
#...........#
#...........#
#...........#
#...........#
#..D........#
#......P1....#
#############
