#############
#....P1......#
#...........#
#...........#
#...........#
#...........#
#D..........#
#############
