#############
#.........D.#
#...........#
#...........#
#...........#
#...........#
#..........P1#
#############
