#############
#...........#
#...........#
#.....P1.....#
#...........#
#...........#
#..D........#
#############
