#############
#...........#
#...........#
#...........#
#........P1..#
#......D....#
#...........#
#############
