#############
#...........#
#...........#
#...........#
#...........#
#D..........#
#.........P1.#
#############
