#############
#...........#
#...........#
#...........#
#.....D.....#
#.......P1...#
#...........#
#############
