#############
#...........#
#...........#
#...........#
#...........#
#.P1.........#
#........D..#
#############
