#############
#.P1.........#
#...........#
#...........#
#......D....#
#...........#
#...........#
#############
