#############
#......D..P1.#
#...........#
#...........#
#...........#
#...........#
#...........#
#############
