#############
#...........#
#...........#
#...D.......#
#...........#
#...........#
#...P1.......#
#############
