#############
#...........#
#...........#
#.....P1D....#
#...........#
#...........#
#...........#
#############
