#############
#...........#
#......P1....#
#..D........#
#...........#
#...........#
#...........#
#############
