#############
#.D.........#
#.......P1...#
#...........#
#...........#
#...........#
#...........#
#############
