#############
#...........#
#...........#
#...........#
#...........#
#...........#
#..DP1.......#
#############
