#############
#...........#
#.P1.........#
#...........#
#...........#
#...........#
#..D........#
#############
