#############
#.........D.#
#..P1........#
#...........#
#...........#
#...........#
#...........#
#############
