#############
#...........#
#..........P1#
#...........#
#...........#
#...........#
#..........D#
#############
