#############
#P1..........#
#...........#
#...........#
#.......D...#
#...........#
#...........#
#############
