#############
#D..........#
#...........#
#...........#
#...........#
#......P1....#
#...........#
#############
