#############
#...........#
#..........D#
#...........#
#........P1..#
#...........#
#...........#
#############
