#############
#...........#
#...........#
#...........#
#..........P1#
#D..........#
#...........#
#############
