#############
#...........#
#...........#
#.P1D........#
#...........#
#...........#
#...........#
#############
