#############
#...........#
#...........#
#D..........#
#......P1....#
#...........#
#...........#
#############
