#############
#...D.......#
#...........#
#...........#
#........P1..#
#...........#
#...........#
#############
