#############
#...........#
#........P1..#
#....D......#
#...........#
#...........#
#...........#
#############
