#############
#...........#
#..#######..#
#...........#
######.######
#...........#
#############