#############
#.....#.....#
#.....#.....#
#.....#.....#
#.....#.....#
###.#####.###
###.......###
#############