################
#........P1.....#
#..............#
#######.########
#..............#
#...########...#
#..........D...#
#..............#
######...#######
#..............#
#...########...#
#..............#
#..............#
#######.########
#..............#
################
