################
#..............#
#..............#
#######.########
#....P1.........#
#...########...#
#..............#
#..............#
######...#######
#...........D..#
#...########...#
#..............#
#..............#
#######.########
#..............#
################
