################
#..............#
#..............#
#######.########
#..............#
#...########...#
#..............#
#........P1.....#
######...#######
#..............#
#.D.########...#
#..............#
#..............#
#######.########
#..............#
################
