################
#..............#
#......P1.......#
#######.########
#..............#
#...########...#
#..............#
#..............#
######...#######
#..............#
#...########...#
#..............#
#.D............#
#######.########
#..............#
################
