################
#..............#
#.........P1....#
#######.########
#..............#
#...########...#
#..............#
#..............#
######...#######
#..............#
#...########D..#
#..............#
#..............#
#######.########
#..............#
################
