################
#..............#
#...........D..#
#######.########
#..............#
#...########...#
#..............#
#..............#
######...#######
#..............#
#...########...#
#..............#
#P1.............#
#######.########
#..............#
################
