################
#..........D...#
#..............#
#######.########
#..............#
#...########...#
#..............#
#..............#
######...#######
#.............P1#
#...########...#
#..............#
#..............#
#######.########
#..............#
################
