################
#..............#
#..............#
#######.########
#..............#
#...########...#
#..............#
#..............#
######...#######
#..............#
#...########.P1.#
#......D.......#
#..............#
#######.########
#..............#
################
