################
#..............#
#..............#
#######.########
#..............#
#...########...#
#..............#
#..............#
######...#######
#.......D......#
#...########...#
#..............#
#P1.............#
#######.########
#..............#
################
