################
#......D.......#
#..............#
#######.########
#..............#
#...########...#
#............P1.#
#..............#
######...#######
#..............#
#...########...#
#..............#
#..............#
#######.########
#..............#
################
