################
#..............#
#..............#
#######.########
#..............#
#...########...#
#........P1.....#
#..............#
######...#######
#..............#
#...########...#
#..............#
#..............#
#######.########
#......D.......#
################
