################
#..............#
#.....P1........#
#######.########
#..............#
#...########...#
#..............#
#..D...........#
######...#######
#..............#
#...########...#
#..............#
#..............#
#######.########
#..............#
################
