################
#..............#
#..............#
#######.########
#..............#
#...########...#
#..............#
#..............#
######...#######
#..............#
#...########...#
#..............#
#....P1.........#
#######.########
#.D............#
################
