################
#...........D..#
#..............#
#######.########
#..............#
#...########...#
#..............#
#..............#
######...#######
#..............#
#...########...#
#..............#
#.............P1#
#######.########
#..............#
################
