################
#..............#
#..............#
#######.########
#..............#
#...########...#
#..............#
#...P1..........#
######...#######
#..............#
#...########...#
#........D.....#
#..............#
#######.########
#..............#
################
