################
#..............#
#..............#
#######.########
#..............#
#...########...#
#..............#
#............P1.#
######...#######
#.D............#
#...########...#
#..............#
#..............#
#######.########
#..............#
################
