################
#.D............#
#..............#
#######.########
#..............#
#...########...#
#....P1.........#
#..............#
######...#######
#..............#
#...########...#
#..............#
#..............#
#######.########
#..............#
################
