################
#..............#
#.P1............#
#######.########
#..............#
#...########...#
#..............#
#..........D...#
######...#######
#..............#
#...########...#
#..............#
#..............#
#######.########
#..............#
################
