################
#..............#
#..............#
#######.########
#..............#
#.P1.########...#
#..............#
#..............#
######...#######
#..............#
#.D.########...#
#..............#
#..............#
#######.########
#..............#
################
