################
#......P1.......#
#..............#
#######.########
#..............#
#...########...#
#..............#
#.............D#
######...#######
#..............#
#...########...#
#..............#
#..............#
#######.########
#..............#
################
