################
#...D..........#
#...........P1..#
#######.########
#..............#
#...########...#
#..............#
#..............#
######...#######
#..............#
#...########...#
#..............#
#..............#
#######.########
#..............#
################
