################
#..............#
#..............#
#######.########
#..............#
#...########...#
#..............#
#..............#
######...#######
#..P1...........#
#...########...#
#..............#
#..............#
#######.########
#.............D#
################
