################
#..............#
#..............#
#######.########
#..............#
#...########...#
#..............#
#...........D..#
######...#######
#..............#
#...########...#
#..............#
#..............#
#######.########
#....P1.........#
################
