################
#..............#
#..............#
#######.########
#..............#
#...########...#
#............P1.#
#..............#
######.D.#######
#..............#
#...########...#
#..............#
#..............#
#######.########
#..............#
################
