################
#..............#
#..............#
#######.########
#..............#
#...########...#
#..............#
#..............#
######...#######
#..............#
#...########...#
#..D...........#
#..............#
#######.########
#............P1.#
################
