################
#..............#
#..............#
#######.########
#.........D....#
#...########...#
#..............#
#..............#
######...#######
#.......P1......#
#...########...#
#..............#
#..............#
#######.########
#..............#
################
