################
#.......D......#
#..............#
#######.########
#....P1.........#
#...########...#
#..............#
#..............#
######...#######
#..............#
#...########...#
#..............#
#..............#
#######.########
#..............#
################
