################
#..............#
#..............#
#######.########
#..............#
#...########...#
#..............#
#.D............#
######...#######
#..............#
#...########...#
#..............#
#..............#
#######.########
#.......P1......#
################
