################
#..............#
#..............#
#######.########
#..............#
#...########...#
#..............#
#..............#
######...#######
#....P1.........#
#...########...#
#..............#
#.......D......#
#######.########
#..............#
################
