################
#..............#
#..............#
#######.########
#..............#
#...########...#
#..............#
#D.............#
######...#######
#............P1.#
#...########...#
#..............#
#..............#
#######.########
#..............#
################
