################
#..............#
#..............#
#######.########
#..............#
#...########...#
#..............#
#..............#
######...#######
#...D..........#
#...########...#
#.P1............#
#..............#
#######.########
#..............#
################
