################
#..............#
#..............#
#######.########
#.........D....#
#...########...#
#..............#
#..P1...........#
######...#######
#..............#
#...########...#
#..............#
#..............#
#######.########
#..............#
################
