#############
#...........#
#..#######..#
#...........#
#####...#####
#...........#
#############