################
#..............#
#..............#
#..............#
#..............#
#....#....#....#
#..............#
#..............#
#..............#
#..............#
#....#....#....#
#..............#
#..............#
#..............#
#..............#
################