################
#..............#
#..............#
#..............#
#..............#
#..............#
#..............#
#..............#
#.....D........#
#..............#
#..............#
#..............#
#..............#
#..............#
#...........P1..#
################
