################
#..............#
#..............#
#.D............#
#..............#
#..............#
#..............#
#..............#
#..............#
#..............#
#..............#
#..............#
#..............#
#..............#
#...P1..........#
################
