################
#..............#
#..............#
#..............#
#....D.........#
#..............#
#..............#
#..............#
#..............#
#..............#
#..............#
#..............#
#..............#
#..............#
#...........P1..#
################
