################
#..............#
#P1.............#
#..............#
#..............#
#..............#
#..............#
#..............#
#..............#
#..............#
#..............#
#...........D..#
#..............#
#..............#
#..............#
################
