################
#..............#
#..............#
#..............#
#..............#
#..............#
#..............#
#.........DP1...#
#..............#
#..............#
#..............#
#..............#
#..............#
#..............#
#..............#
################
