################
#............D.#
#..............#
#..............#
#..............#
#..............#
#..............#
#..............#
#..............#
#..............#
#............P1.#
#..............#
#..............#
#..............#
#..............#
################
