################
#..............#
#..............#
#..............#
#..............#
#..............#
#..............#
#..............#
#..............#
#..............#
#..............#
#.............D#
#..............#
#..............#
#.....P1........#
################
