################
#..............#
#..............#
#..............#
#..............#
#.......P1......#
#..............#
#..............#
#..............#
#..............#
#..............#
#..............#
#..............#
#..............#
#............D.#
################
