################
#..............#
#..............#
#..............#
#..............#
#..............#
#..............#
#.....D........#
#..............#
#..............#
#..............#
#.......P1......#
#..............#
#..............#
#..............#
################
