################
#..............#
#..............#
#..............#
#..............#
#..............#
#..............#
#............D.#
#..............#
#..............#
#..............#
#..............#
#..............#
#..............#
#...........P1..#
################
