################
#..........P1...#
#..............#
#..............#
#..............#
#..............#
#..............#
#.........D....#
#..............#
#..............#
#..............#
#..............#
#..............#
#..............#
#..............#
################
