################
#..............#
#..............#
#..............#
#..............#
#..............#
#..............#
#..P1...........#
#..............#
#..............#
#..............#
#............D.#
#..............#
#..............#
#..............#
################
