################
#..............#
#..............#
#..............#
#..............#
#..............#
#...........D..#
#.P1............#
#..............#
#..............#
#..............#
#..............#
#..............#
#..............#
#..............#
################
