################
#..............#
#..............#
#..............#
#..............#
#..............#
#..........P1...#
#..............#
#.D............#
#..............#
#..............#
#..............#
#..............#
#..............#
#..............#
################
