################
#........D.....#
#..............#
#..............#
#..............#
#..............#
#..............#
#..............#
#..............#
#..............#
#....P1.........#
#..............#
#..............#
#..............#
#..............#
################
