################
#..............#
#..............#
#..............#
#..............#
#..............#
#..............#
#..............#
#..............#
#............D.#
#........P1.....#
#..............#
#..............#
#..............#
#..............#
################
