################
#..............#
#D.............#
#..............#
#..............#
#..............#
#..............#
#..............#
#..............#
#..............#
#........P1.....#
#..............#
#..............#
#..............#
#..............#
################
