################
#.............P1#
#..............#
#..............#
#....D.........#
#..............#
#..............#
#..............#
#..............#
#..............#
#..............#
#..............#
#..............#
#..............#
#..............#
################
