################
#......P1.......#
#..............#
#..............#
#..............#
#..............#
#..............#
#..............#
#..............#
#..............#
#..............#
#D.............#
#..............#
#..............#
#..............#
################
