################
#..............#
#....P1.........#
#........D.....#
#..............#
#..............#
#..............#
#..............#
#..............#
#..............#
#..............#
#..............#
#..............#
#..............#
#..............#
################
