################
#..............#
#..............#
#........D.....#
#.P1............#
#..............#
#..............#
#..............#
#..............#
#..............#
#..............#
#..............#
#..............#
#..............#
#..............#
################
