################
#..............#
#..............#
#.P1............#
#.......D......#
#..............#
#..............#
#..............#
#..............#
#..............#
#..............#
#..............#
#..............#
#..............#
#..............#
################
