################
#..............#
#..............#
#...........P1..#
#..............#
#..............#
#..............#
#..............#
#....D.........#
#..............#
#..............#
#..............#
#..............#
#..............#
#..............#
################
