################
#..............#
#..............#
#..............#
#..............#
#............P1.#
#..........D...#
#..............#
#..............#
#..............#
#..............#
#..............#
#..............#
#..............#
#..............#
################
