################
#..............#
#..............#
#..............#
#..............#
#..............#
#..D...........#
#..............#
#..............#
#..............#
#..............#
#..............#
#..............#
#..............#
#..P1...........#
################
