################
#..............#
#..............#
#..............#
#..............#
#.............D#
#......P1.......#
#..............#
#..............#
#..............#
#..............#
#..............#
#..............#
#..............#
#..............#
################
