################
#..............#
#..............#
#..............#
#..............#
#..............#
#..............#
#.......P1......#
#............D.#
#..............#
#..............#
#..............#
#..............#
#..............#
#..............#
################
