################
#..............#
#..............#
#..............#
#..............#
#..............#
#..............#
#..............#
#..............#
#......P1.......#
#.D............#
#..............#
#..............#
#..............#
#..............#
################
