################
#..............#
#..............#
#..............#
#..............#
#..............#
#......P1.......#
#.............D#
#..............#
#..............#
#..............#
#..............#
#..............#
#..............#
#..............#
################
