################
#.D............#
#..............#
#..............#
#..............#
#..............#
#..P1...........#
#..............#
#..............#
#..............#
#..............#
#..............#
#..............#
#..............#
#..............#
################
