################
#..............#
#.......P1......#
#..............#
#..............#
#..............#
#.........D....#
#..............#
#..............#
#..............#
#..............#
#..............#
#..............#
#..............#
#..............#
################
