################
#...........D..#
#..............#
#..............#
#..............#
#..............#
#..............#
#.......P1......#
#..............#
#..............#
#..............#
#..............#
#..............#
#..............#
#..............#
################
