################
#..............#
#..............#
#..............#
#..............#
#..............#
#..............#
#..............#
#..............#
#..............#
#........P1.....#
#........D.....#
#..............#
#..............#
#..............#
################
