################
#..............#
#..............#
#..............#
#..............#
#..............#
#..............#
#..............#
#..........P1...#
#..............#
#..............#
#..............#
#..............#
#..............#
#............D.#
################
