################
#..............#
#..............#
#..............#
#..............#
#..............#
#..............#
#..............#
#..............#
#..............#
#..............#
#...........P1..#
#..........D...#
#..............#
#..............#
################
