################
#..............#
#..............#
#..............#
#D.............#
#........P1.....#
#..............#
#..............#
#..............#
#..............#
#..............#
#..............#
#..............#
#..............#
#..............#
################
