################
#..............#
#..............#
#..........D...#
#..............#
#..............#
#..............#
#.............P1#
#..............#
#..............#
#..............#
#..............#
#..............#
#..............#
#..............#
################
