################
#..............#
#..............#
#..............#
#..............#
#..............#
#..............#
#..............#
#......D.......#
#..............#
#..............#
#..............#
#....P1.........#
#..............#
#..............#
################
