################
#..............#
#..............#
#..............#
#..............#
#..............#
#..............#
#..............#
#..............#
#..............#
#..............#
#...........D..#
#..............#
#..............#
#......P1.......#
################
