################
#..............#
#..............#
#..............#
#..............#
#..............#
#..............#
#.......D......#
#..............#
#..............#
#..............#
#..........P1...#
#..............#
#..............#
#..............#
################
