################
#...........P1..#
#..............#
#..............#
#..............#
#.........D....#
#..............#
#..............#
#..............#
#..............#
#..............#
#..............#
#..............#
#..............#
#..............#
################
