################
#..............#
#..............#
#..............#
#D.............#
#..............#
#..............#
#..............#
#....P1.........#
#..............#
#..............#
#..............#
#..............#
#..............#
#..............#
################
