################
#..............#
#..............#
#..............#
#..............#
#..............#
#..............#
#...D..........#
#.......P1......#
#..............#
#..............#
#..............#
#..............#
#..............#
#..............#
################
