################
#..............#
#..............#
#..............#
#..............#
#..............#
#..............#
#..............#
#..............#
#............P1.#
#........D.....#
#..............#
#..............#
#..............#
#..............#
################
