################
#..............#
#..............#
#..............#
#..............#
#..............#
#..............#
#............P1.#
#..............#
#....D.........#
#..............#
#..............#
#..............#
#..............#
#..............#
################
