################
#..............#
#..............#
#..............#
#..............#
#..............#
#.D............#
#..............#
#..............#
#..............#
#..............#
#..............#
#..............#
#..............#
#..P1...........#
################
