################
#..............#
#..............#
#..............#
#......P1.......#
#..............#
#..............#
#..............#
#......D.......#
#..............#
#..............#
#..............#
#..............#
#..............#
#..............#
################
