################
#..............#
#..............#
#..............#
#..............#
#...........P1..#
#..............#
#..............#
#..............#
#..............#
#............D.#
#..............#
#..............#
#..............#
#..............#
################
