################
#..............#
#..............#
#..............#
#..............#
#..............#
#..............#
#..............#
#..............#
#.......P1......#
#...........D..#
#..............#
#..............#
#..............#
#..............#
################
