################
#..............#
#..............#
#......P1.......#
#..............#
#..............#
#..............#
#.......D......#
#..............#
#..............#
#..............#
#..............#
#..............#
#..............#
#..............#
################
