################
#..............#
#..............#
#.........P1....#
#..............#
#..............#
#..............#
#..............#
#..............#
#..............#
#..............#
#..............#
#..............#
#..............#
#........D.....#
################
