################
#..............#
#..............#
#..............#
#..............#
#..............#
#..............#
#..........P1...#
#........D.....#
#..............#
#..............#
#..............#
#..............#
#..............#
#..............#
################
