################
#..............#
#..............#
#..............#
#..............#
#..............#
#..............#
#..............#
#..............#
#..............#
#.........P1....#
#..............#
#..............#
#..............#
#.......D......#
################
