################
#..............#
#..............#
#..............#
#..............#
#..............#
#..............#
#..............#
#..............#
#..............#
#........D.....#
#..............#
#..............#
#..............#
#.......P1......#
################
