################
#....P1.........#
#..............#
#..............#
#..............#
#..............#
#.D............#
#..............#
#..............#
#..............#
#..............#
#..............#
#..............#
#..............#
#..............#
################
