################
#..............#
#..............#
#..............#
#..............#
#..............#
#..............#
#..............#
#..............#
#..............#
#D.......P1.....#
#..............#
#..............#
#..............#
#..............#
################
