################
#..............#
#..............#
#..............#
#..............#
#.........P1....#
#..............#
#..............#
#..............#
#..............#
#..............#
#..............#
#..............#
#..............#
#.........D....#
################
