################
#..............#
#..........D...#
#..............#
#..............#
#..............#
#..............#
#..............#
#..............#
#..............#
#..............#
#..............#
#..............#
#....P1.........#
#..............#
################
