################
#..............#
#..............#
#..............#
#.............D#
#..............#
#..............#
#..............#
#..............#
#..............#
#..............#
#..............#
#............P1.#
#..............#
#..............#
################
