################
#..............#
#..............#
#..............#
#..............#
#..............#
#..............#
#..............#
#..............#
#..............#
#..............#
#...D..........#
#..............#
#..............#
#.............P1#
################
