##########
#........#
#........#
#P1.......#
#....D...#
##########
