##########
#P1.......#
#.......D#
#........#
#........#
##########
