##########
#D...P1...#
#........#
#........#
#........#
##########
