##########
#........#
#........#
#........#
#..D...P1.#
##########
