##########
#..D.....#
#........#
#........#
#...P1....#
##########
