##########
#........#
#........#
#.......P1#
#D.......#
##########
