##########
#........#
#........#
#........#
#DP1......#
##########
