##########
#........#
#.......P1#
#........#
#...D....#
##########
