##########
#....D.P1.#
#........#
#........#
#........#
##########
