##########
#........#
#.P1......#
#......D.#
#........#
##########
