##########
#........#
#.....D..#
#...P1....#
#........#
##########
