##########
#........#
#....P1...#
#....D...#
#........#
##########
