##########
#P1.......#
#........#
#........#
#.......D#
##########
