##########
#........#
#........#
#.......D#
#P1.......#
##########
