##########
#........#
#P1.......#
#...D....#
#........#
##########
