##########
#P1.......#
#........#
#........#
#...D....#
##########
