##########
#.......D#
#.......P1#
#........#
#........#
##########
