##########
#........#
#..D.....#
#......P1.#
#........#
##########
