##########
#........#
#.P1....D.#
#........#
#........#
##########
