##########
#......P1.#
#........#
#D.......#
#........#
##########
