##########
#....P1...#
#........#
#........#
#......D.#
##########
