##########
#D.......#
#.P1......#
#........#
#........#
##########
