##########
#........#
#........#
#........#
#.....P1.D#
##########
