##########
#........#
#....D...#
#........#
#....P1...#
##########
