##########
#........#
#....D...#
#........#
#P1.......#
##########
