##########
#P1.......#
#D.......#
#........#
#........#
##########
