##########
#........#
#....D...#
#.P1......#
#........#
##########
