##########
#........#
#..P1.....#
#......D.#
#........#
##########
