##########
#..D....P1#
#........#
#........#
#........#
##########
