##########
#........#
#........#
#.....P1..#
#...D....#
##########
