##########
#.D......#
#........#
#........#
#...P1....#
##########
