##########
#.......P1#
#........#
#...D....#
#........#
##########
