##########
#........#
#.....D..#
#........#
#...P1....#
##########
