##########
#.P1......#
#......D.#
#........#
#........#
##########
