##########
#........#
#......P1.#
#........#
#..D.....#
##########
