##########
#........#
#D.......#
#........#
#...P1....#
##########
