##########
#..P1.....#
#.....D..#
#........#
#........#
##########
