##########
#........#
#P1....D..#
#........#
#........#
##########
