##########
#........#
#.D.....P1#
#........#
#........#
##########
