##########
#........#
#........#
#.D......#
#.P1......#
##########
