##########
#........#
#.......D#
#........#
#.P1......#
##########
