##########
#........#
#........#
#P1...D...#
#........#
##########
