##########
#........#
#....D...#
#..P1.....#
#........#
##########
