##########
#......D.#
#........#
#........#
#......P1.#
##########
