##########
#...P1....#
#..D.....#
#........#
#........#
##########
