##########
#....D...#
#........#
#........#
#.....P1..#
##########
