##########
#........#
#.......P1#
#........#
#.D......#
##########
