##########
#........#
#........#
#.P1......#
#......D.#
##########
