##########
#........#
#....D...#
#....P1...#
#........#
##########
