##########
#........#
#........#
#.......D#
#......P1.#
##########
