##########
#..P1.....#
#......D.#
#........#
#........#
##########
