##########
#........#
#.P1......#
#D.......#
#........#
##########
