##########
#.......P1#
#....D...#
#........#
#........#
##########
