##########
#........#
#.D......#
#........#
#P1.......#
##########
