##########
#........#
#.....D..#
#........#
#......P1.#
##########
