##########
#........#
#.......P1#
#.....D..#
#........#
##########
