##########
#........#
#........#
#........#
#D..P1....#
##########
