##########
#....D...#
#........#
#....P1...#
#........#
##########
