##########
#........#
#..P1.....#
#...D....#
#........#
##########
