##########
#.P1......#
#........#
#.....D..#
#........#
##########
