##########
#........#
#........#
#..P1.....#
#...D....#
##########
