##########
#........#
#.....DP1.#
#........#
#........#
##########
