##########
#D.......#
#........#
#P1.......#
#........#
##########
