##########
#........#
#....D...#
#........#
#.....P1..#
##########
