##########
#.....P1..#
#........#
#..D.....#
#........#
##########
