##########
#.....P1..#
#.D......#
#........#
#........#
##########
