##########
#........#
#........#
#D.......#
#.P1......#
##########
