##########
#P1.......#
#........#
#.....D..#
#........#
##########
