##########
#......D.#
#.P1......#
#........#
#........#
##########
