##########
#.....P1..#
#D.......#
#........#
#........#
##########
