##########
#.......P1#
#...D....#
#........#
#........#
##########
