##########
#....P1...#
#.......D#
#........#
#........#
##########
