##########
#........#
#...P1....#
#........#
#..D.....#
##########
