##########
#........#
#P1.......#
#......D.#
#........#
##########
