##########
#........#
#........#
#D.......#
#.......P1#
##########
