##########
#..P1.....#
#........#
#........#
#.D......#
##########
