##########
#...P1....#
#........#
#....D...#
#........#
##########
