##########
#........#
#........#
#........#
#.P1D.....#
##########
