##########
#...P1....#
#.....D..#
#........#
#........#
##########
