##########
#........#
#........#
#....P1.D.#
#........#
##########
