##########
#........#
#..D.....#
#P1.......#
#........#
##########
