##########
#........#
#.....P1..#
#D.......#
#........#
##########
