##########
#........#
#P1.......#
#.......D#
#........#
##########
