##########
#........#
#..P1.....#
#........#
#.......D#
##########
