##########
#D.......#
#....P1...#
#........#
#........#
##########
