##########
#........#
#........#
#........#
#...P1D...#
##########
