##########
#........#
#........#
#.......P1#
#......D.#
##########
