##########
#....P1...#
#........#
#.....D..#
#........#
##########
