##########
#.D......#
#..P1.....#
#........#
#........#
##########
