##########
#........#
#........#
#........#
#D.P1.....#
##########
